1111111111111111
100CCXCCECC00001
1000111110C0C001
1E0C100011100101
10100P000C10C0C1
100C1C0C10110101
1E0CCC010000C001
1111111111111111
