1111111111111111
1000000000000001
1000111110000001
1000100011100101
10100P0000100001
1000100010110101
1E00000100000001
1111111111111111
