111111111111
101P0001C111
111000010111
111E0C111101
111111111111
