1111111111111111
100CC0CC0CC000011
1000111110C0C00111
100C100011100101111
10100P000C10C0C11111
100C1C0C1011010111111
1E0CCC010000C001111111
11111111111111111111111
