11111111111111111111
100CC0CC0CC000000001
100CC0CC0CC000000001
1000111110C0C0000001
100C1000111001000001
10100P000C10C00000C1
100C1C0C101101000001
1E0CCC010000C0000001
11111111111111111111
